TST = "countries/Test.txt"
AES = "countries/AlliedEthoState.txt"
ALT = "countries/Alterea.txt"
AVA = "countries/Avalon.txt"
BOM = "countries/Bomberland.txt"
BYS = "countries/Bystormia.txt"
CRG = "countries/Corgromania.txt"
CFT = "countries/Craftia.txt"
CNK = "countries/ChonkCorp.txt"
KKD = "countries/KorgiKingdom"
BRK = "countries/Borkers.txt"
DAR = "countries/Darkness.txt"
CCO = "countires/CorgiCollective.txt"
COO = "countries/Coolistan.txt"
DOG = "countries/Dogland.txt"
SBA = "countries/ShibaKingdom.txt"
FLD = "countries/FloodsGate.txt"
LIV = "countries/Livonia.txt"
JAZ = "countries/Jazzerland.txt"
KBR = "countries/KerbalRepublic.txt"
GRK = "countries/Grockleand.txt"
MTH = "countries/Mithrandier.txt"
NEK = "countries/Nekinn.txt"
NER = "countries/Nerdia.txt"
NPR = "countries/NorthernPotatoRealm.txt"
NTH = "countries/Netherlands.txt"
OHA = "countries/Ohana.txt"
PUG = "counties/PugFederation.txt"
NVP = "countries/NewVooperis.txt"
OOF = "countries/Oofia.txt"
RIC = "countries/Ricea.txt"
CON = "countries/CultOfNerds.txt"
ALE = "countries/Allegatia.txt"
POP = "countries/TheHolySee.txt"
KOM = "countries/KingdomOfMoney.txt"
PTP = "countries/PotatoTribespeople.txt"
SHB = "countries/Shibsburg.txt"
SLA = "countries/Solaria.txt"
SOR = "countries/Sporia.txt"
SCP = "countries/SpudCorp.txt"
SDL = "countries/Spudland.txt"
SPL = "countries/Spleenia.txt"
STR = "countries/Starbux.txt"
TEM = "countries/Tempest.txt"
TEP = "countries/Tepstonia.txt"
VAL = "countries/Valar.txt"
VAS = "countries/VoopmontAnarchistState.txt"
VME = "countries/VoopMechanists.txt"
VOI = "countries/Void.txt"
VOP = "countries/Vooperia.txt"
VPR = "countries/Vooperisco.txt"
WNC = "countries/WhiteNameCommune.txt"
YAM = "countries/Yamland.txt"
YES = "countries/CorporateStateOfYes.txt"
YMR = "countries/YamRepublic.txt"
ZAR = "countries/Zardox.txt"